##################################################### 
||                                                 || 
|| #############     ############     ############ || 
||             %                                   || 
||             %                                   || 
||             %                                   || 
||                                                 || 
|| ############      ############     ############ || 
||                                                 || 
||                                                 || 
||                                                 || 
||                                                 || 
|| ############     .############     ############.|| 
||                                                 || 
||                                                 || 
||             %                                   || 
||             %                                   || 
||             %                                   || 
|| #############     ############     ############ || 
||                                                 || 
##################################################### 